111111111111
1111C1C000C1
111C01111101
1100010C0001
1P0000C11111
111C01C000E1
111111111111