1111111
10P0001
1000E01
1111111