1111111111111111111111111111111111111111111111111111111111111111111111111111
1000000000100000000000000000000000000000000000000000000000000000000000000001
1011101110101110111001110111001110111001110111000000000000000000000000000001
1C10101010101010101C01010101C01010101C01010101C00000000000000000000000000001
1011101110101110111001110111001110111001110111000000000000000000000000000001
1000000000000000000000000000000000000000000000000000000000000000000000000001
1011101011111010111011010111011010111011010111000000000000000000000000000001
1011101011111010111011010111011010111011010111000000000000000000000000000001
1000001000100010000000010000000010000000010000000000000000000000000000000001
1111101110101110111101110111101110111101110111100000000000000000000000000001
1000101000000010100000010100000010100000010100000000000000000000000000000001
1000101011111010100011010100011010100011010100000000000000000000000000000001
1111101010001010111101010111101010111101010111100000000000000000000000000001
1000000010001000000001000000001000000001000000000000000000000000000000000001
1111101011111010111111010111111010111111010111100000000000000000000000000001
1000101000E00010100000010100000010100000010100000000000000000000000000000001
1000101011111010100011010100011010100011010100000000000000000000000000000001
1111101011111010111111010111111010111111010111100000000000000000000000000001
1000000000100000000000000000000000000000000000000000000000000000000000000001
1011101110101110111001110111001110111001110111000000000000000000000000000001
1C00100000P00000100C00000100C00000100C00000100C00000000000000000000000000001
1110101011111010101111010101111010101111010101100000000000000000000000000001
1110101011111010101111010101111010101111010101100000000000000000000000000001
1000001000100010000000010000000010000000010000000000000000000000000000000001
1011111110101111111001111111001111111001111111000000000000000000000000000001
1000000000000000000000000000000000000000000000000000000000000000000000000001
1000000000100000000000000000000000000000000000000000000000000000000000000001
1000000000100000000000000000000000000000000000000000000000000000000000000001
1000000000100000000000000000000000000000000000000000000000000000000000000001
1000000000100000000000000000000000000000000000000000000000000000000000000001
1000000000100000000000000000000000000000000000000000000000000000000000000001
1000000000100000000000000000000000000000000000000000000000000000000000000001
1000000000100000000000000000000000000000000000000000000000000000000000000001
1000000000100000000000000000000000000000000000000000000000000000000000000001
1000000000100000000000000000000000000000000000000000000000000000000000000001
1000000000100000000000000000000000000000000000000000000000000000000000000001
1000000000100000000000000000000000000000000000000000000000000000000000000001
1000000000100000000000000000000000000000000000000000000000000000000000000001
1000000000100000000000000000000000000000000000000000000000000000000000000001
1000000000100000000000000000000000000000000000000000000000000000000000000001
1111111111111111111111111111111111111111111111111111111111111111111111111111