1111111111111
1111C1C000C11
111C011111011
1100010C00011
1P0000C111111
111C01C0000E1
1111111111111