1111111111111
100000CCC00E1
100000CCC00E1
100000CCC0PE1
1111111111111