1111111111111
100000CCC00E1
100000CCC0011
100000CCC0111
100000CCC0011
100000CCC0011
100000CCC0P11
1111111111111