111111
110001
100CC1
100001
100001
11E1P1
111111