1111111111
1C000100C1
100111C1C1
10011011C1
1CEEEE0P01
1111111111