111111111111111111111
100000000010000000001
101110111010111011101
1C10101010101010101C1
101110111010111011101
100000000000000000001
101110101111101011101
101110101111101011101
100000100010001000001
111110111010111011111
100010100000001010001
100010101111101010001
111110101000101011111
100000001000100000001
111110101111101011111
1000101000E0001010001
100010101111101010001
111110101111101011111
100000000010000000001
101110111010111011101
1C00100000P00000100C1
111010101111101010111
111010101111101010111
100000100010001000001
101111111010111111101
100000000000000000001
111111111111111111111