1111111111111111111111111111111111
1E0000000000000C001000000000000001
1010010100100000101000000000010101
1100010010101010001001000000010101
1P0000000C00C0000010010000000000C1
1111111111111111111111111111111111