1111111111111111111111111111111111
1E1000000000000C000000000000000001
1110010100100000101000000000010101
1100010010101010001001000000010101
1P0000000C00C0000000010000000000C1
1111111111111111111111111111111111