11111111111111111111111
1EE00000010000C000C0001
1EE00101010101010010101
10100101010101010110101
1P001110C00C010000001C1
10100101010101010010101
10110101010101011010101
1C100000C00C000000100C1
11111111111111111111111