1111111111111111111
1E00000010010C00101
1100101010100011001
1010010101010110101
1P001110C00C00001C1
1010010101010110101
1011010101010110101
1C100000C000001E0C1
1111111111111111111