1111111
1P00C11
1F1E111
1111111