1111111111111
1C010000000C0
1000011111000
1P0011E000000
1111111111111