1111111111111
100100
1000C11111001
1P0011E000
11111111